,index,feedername,complete,in_progress,total
0,3129,SGA10VB01,0,15,15
1,0,PAN10VB01,0,0,0
2,3126,SGA07VB01,0,5,5
3,0,LPB01VB01,0,0,0
4,1365,LNB06VB01,0,1,1
5,0,PAU05VB01,0,0,0
6,0,CEA04VB01,0,0,0
7,1390,MCA02VB01,1,0,1
8,0,CRA09VB01,0,0,0
9,0,NIC06VB01,0,0,0
10,1228,CHM02VB01,6,2,8
11,3124,SGA05VB01,4,10,14
12,1405,MEA09VB01,1,0,1
13,1430,MRM10VB01,25,4,29
14,1428,MRM08VB01,0,9,9
15,1420,MLA09VB01,2,0,2
16,1316,CSA01VB01,1,0,1
17,1356,LNA01VB01,2,9,11
18,1411,MHA04VB01,6,7,13
19,1317,CSA05VB01,1,0,1
20,1260,CMC08VB01,2,0,2
21,1449,PAU02VB01,4,99,103
22,0,TEA04VB01,0,0,0
23,1303,CRA06VB01,2,0,2
24,1256,CMC03VB01,8,13,21
25,1369,LNC02VB01,2,0,2
26,0,HOA03VB01,0,0,0
27,1372,LNC06VB01,4,2,6
28,1403,MEA07VB01,7,0,7
29,1427,MRM07VB01,39,38,77
30,1447,PAS05VB01,12,0,12
31,1456,PYA05VB01,18,27,45
32,1408,MHA01VB01,35,140,175
33,0,WPA01VB01,0,0,0
34,1272,CMD04VB01,31,11,42
35,0,XSU01VB01,0,0,0
36,1426,MRM06VB01,19,57,76
37,1315,CRB10VB01,5,5,10
38,0,NIU04VB01,0,0,0
39,1388,LPC03VB01,0,19,19
40,1442,PAN04VB01,15,0,15
41,1282,CMF01VB01,3,6,9
42,1301,CRA04VB01,5,1,6
43,1232,CMA01VB01,38,14,52
44,0,TNG04VB01,0,0,0
45,0,CKN02VB01,0,0,0
46,1227,CHM01VB01,5,0,5
47,1235,CMA04VB01,2,12,14
48,1379,LPA10VB01,19,5,24
49,0,HOA01VB01,0,0,0
50,1389,MCA01VB01,1,0,1
51,1261,CMC09VB01,12,7,19
52,1417,MLA02VB01,8,0,8
53,1344,HCA05VB01,6,0,6
54,0,HOA06VB01,0,0,0
55,0,LPB08VB01,0,0,0
56,1292,CMV01VB01,2,1,3
57,1357,LNA02VB01,6,29,35
58,0,MTA03VB01,0,0,0
59,0,XSU03VB01,0,0,0
60,1220,CDO04VB01,7,0,7
61,0,CRB03VB01,0,0,0
62,0,TEA03VB01,0,0,0
63,0,PYB03VB01,0,0,0
64,0,MJU01VB01,0,0,0
65,0,NIC03VB01,0,0,0
66,0,MTA01VB01,0,0,0
67,0,MLA07VB01,0,0,0
68,0,LPA02VB01,0,0,0
69,1423,MRM03VB01,0,15,15
70,1276,CMD08VB01,23,24,47
71,1296,CMV05VB01,4,4,8
72,0,PAS01VB01,0,0,0
73,1274,CMD06VB01,81,14,95
74,1271,CMD03VB01,15,0,15
75,1233,CMA02VB01,9,5,14
76,1293,CMV02VB01,3,5,8
77,1438,NIU03VB01,2,0,2
78,0,MLA03VB01,0,0,0
79,1255,CMC02VB01,8,2,10
80,0,TEA05VB01,0,0,0
81,1419,MLA06VB01,4,0,4
82,1270,CMD02VB01,10,0,10
83,1212,WPA08VB01,6,3,9
84,0,PAN09VB01,0,0,0
85,0,HOA05VB01,0,0,0
86,1413,MHA07VB01,4,4,8
87,1203,TNG07VB01,4,1,5
88,0,NIC02VB01,0,0,0
89,1300,CRA03VB01,11,2,13
90,1437,NIA06VB01,0,0,0
91,1455,PYA04VB01,41,4,45
92,1284,CMF03VB01,5,16,21
93,1336,FAA06VB01,7,0,7
94,0,NIC08VB01,0,0,0
95,0,PAN06VB01,0,0,0
96,1352,LIA03VB01,11,0,11
97,1351,LIA02VB01,9,0,9
98,1201,TNG02VB01,21,5,26
99,1391,MCA03VB01,1,0,1
100,1242,CMB01VB01,50,34,84
101,1210,WPA04VB01,3,2,5
102,0,MHA05VB01,0,0,0
103,0,LPA01VB01,0,0,0
104,1269,CMD01VB01,16,10,26
105,0,CMU03VB01,0,0,0
106,1223,CEA03VB01,1,0,1
107,1339,FAA09VB01,12,0,12
108,1321,CUN02VB01,1,0,1
109,0,LPA04VB01,0,0,0
110,1380,LPB02VB01,0,8,8
111,1249,CMB08VB01,17,49,66
112,0,PAU03VB01,0,0,0
113,1406,MEA10VB01,7,0,7
114,1367,LNB10VB01,1,0,1
115,1439,PAN01VB01,5,0,5
116,1332,FAA01VB01,13,0,13
117,1244,CMB03VB01,19,15,34
118,0,NIC07VB01,0,0,0
119,0,CSA04VB01,0,0,0
120,0,XSU02VB01,0,0,0
121,1295,CMV04VB01,4,2,6
122,1196,SKP09VB01,0,4,4
123,1398,MEA01VB01,14,0,14
124,1412,MHA06VB01,9,11,20
125,1387,LPC02VB01,0,14,14
126,0,NIC10VB01,0,0,0
127,0,XSU04VB01,0,0,0
128,0,MLA04VB01,0,0,0
129,0,MFU02VB01,0,0,0
130,0,TEA02VB01,0,0,0
131,0,BGA03VB01,0,0,0
132,1283,CMF02VB01,22,6,28
133,1443,PAN05VB01,16,0,16
134,1358,LNA03VB01,29,18,47
135,0,BGA01VB01,0,0,0
136,1254,CMC01VB01,4,3,7
137,0,LNB09VB01,0,0,0
138,0,MHA10VB01,0,0,0
139,1448,PAU01VB01,5,67,72
140,1238,CMA07VB01,5,30,35
141,1240,CMA09VB01,23,1,24
142,0,TEA10VB01,0,0,0
143,1262,CMC10VB01,1,0,1
144,0,CUN05VB01,0,0,0
145,0,MAA03VB01,0,0,0
146,1319,CSA09VB01,0,3,3
147,1384,LPB06VB01,14,6,20
148,0,MAA04VB01,0,0,0
149,1323,CUN04VB01,3,0,3
150,0,WPA10VB01,0,0,0
151,1395,MCA07VB01,1,0,1
152,0,LPC05VB01,0,0,0
153,0,CRB06VB01,0,0,0
154,0,CUN10VB01,0,0,0
155,1399,MEA02VB01,1,0,1
156,0,NIU02VB01,0,0,0
157,1206,TNG10VB01,10,1,11
158,1231,CKN03VB01,1,0,1
159,1368,LNC01VB01,1,0,1
160,0,WPA06VB01,0,0,0
161,3125,SGA06VB01,1,1,2
162,0,PAN08VB01,0,0,0
163,0,MLA08VB01,0,0,0
164,0,CDO05VB01,0,0,0
165,1354,LIA05VB01,6,0,6
166,0,TEA08VB01,0,0,0
167,1190,SKP02VB01,8,19,27
168,1245,CMB04VB01,63,3,66
169,1234,CMA03VB01,50,28,78
170,1193,SKP06VB01,19,0,19
171,0,DKA09VB01,0,0,0
172,0,NIC05VB01,0,0,0
173,1217,CDO01VB01,4,0,4
174,1251,CMB10VB01,47,7,54
175,1294,CMV03VB01,9,7,16
176,0,BGA04VB01,0,0,0
177,1375,LPA06VB01,41,4,45
178,0,HOA02VB01,0,0,0
179,0,WPA07VB01,0,0,0
180,1373,LNC10VB01,0,3,3
181,1359,LNA04VB01,4,0,4
182,1429,MRM09VB01,9,11,20
183,1360,LNA05VB01,6,0,6
184,0,CSA03VB01,0,0,0
185,3127,SGA08VB01,5,9,14
186,1326,DKA04VB01,1,0,1
187,1257,CMC04VB01,1,2,3
188,1453,PYA02VB01,36,0,36
189,1289,CMU02VB01,62,8,70
190,1325,DKA02VB01,37,0,37
191,1363,LNB03VB01,1,0,1
192,0,CME03VB01,0,0,0
193,0,CKN05VB01,0,0,0
194,1404,MEA08VB01,7,0,7
195,1350,LIA01VB01,2,0,2
196,1288,CMU01VB01,0,4,4
197,1246,CMB05VB01,36,19,55
198,0,BGA02VB01,0,0,0
199,1334,FAA03VB01,10,0,10
200,0,CEA08VB01,0,0,0
201,1440,PAN02VB01,7,0,7
202,0,CEA05VB01,0,0,0
203,0,MEA06VB01,0,0,0
204,3120,SGA01VB01,34,12,46
205,0,XSU05VB01,0,0,0
206,1394,MCA06VB01,2,0,2
207,1400,MEA03VB01,12,0,12
208,0,LNB01VB01,0,0,0
209,1346,HOA08VB01,12,140,152
210,1329,DKA08VB01,1,0,1
211,1277,CMD09VB01,2,7,9
212,0,MAA02VB01,0,0,0
213,1459,PYA08VB01,24,4,28
214,1454,PYA03VB01,82,23,105
215,0,LNC05VB01,0,0,0
216,1461,PYB02VB01,9,0,9
217,0,CME01VB01,0,0,0
218,1290,CMU04VB01,11,32,43
219,1371,LNC04VB01,6,27,33
220,1205,TNG09VB01,19,1,20
221,1342,HCA03VB01,2,16,18
222,1424,MRM04VB01,35,41,76
223,0,LPC04VB01,0,0,0
224,1386,LPC01VB01,0,21,21
225,1418,MLA05VB01,6,0,6
226,0,MJU02VB01,0,0,0
227,0,TNG06VB01,0,0,0
228,0,HOA12VB01,0,0,0
229,0,HOA04VB01,0,0,0
230,1191,SKP03VB01,8,8,16
231,1401,MEA04VB01,8,0,8
232,1416,MLA01VB01,4,0,4
233,0,CRA02VB01,0,0,0
234,1338,FAA08VB01,59,1,60
235,1192,SKP05VB01,1,2,3
236,1445,PAS02VB01,1,0,1
237,1435,NIA03VB01,2,3,5
238,0,DKA07VB01,0,0,0
239,3123,SGA04VB01,5,3,8
240,0,TEA07VB01,0,0,0
241,0,LNB04VB01,0,0,0
242,1402,MEA05VB01,7,0,7
243,0,NIA08VB01,0,0,0
244,1189,SKP01VB01,0,2,2
245,1285,CMF04VB01,18,12,30
246,1347,HOA09VB01,3,0,3
247,1458,PYA07VB01,77,40,117
248,0,NIA10VB01,0,0,0
249,0,WPA09VB01,0,0,0
250,0,CRA07VB01,0,0,0
251,0,CUN08VB01,0,0,0
252,1353,LIA04VB01,34,0,34
253,0,MCA09VB01,0,0,0
254,1374,LPA03VB01,0,11,11
255,1393,MCA05VB01,2,0,2
256,1305,CRA10VB01,4,0,4
257,1410,MHA03VB01,45,6,51
258,0,MTA02VB01,0,0,0
259,1247,CMB06VB01,19,13,32
260,1309,CRB02VB01,10,0,10
261,1229,CHM03VB01,11,0,11
262,0,NIA02VB01,0,0,0
263,1250,CMB09VB01,46,15,61
264,0,CUN07VB01,0,0,0
265,1377,LPA08VB01,19,3,22
266,0,MCA10VB01,0,0,0
267,1381,LPB03VB01,0,14,14
268,0,NIA09VB01,0,0,0
269,1392,MCA04VB01,1,0,1
270,0,CSA08VB01,0,0,0
271,0,PYB01VB01,0,0,0
272,1302,CRA05VB01,1,3,4
273,1335,FAA04VB01,33,17,50
274,0,PYB05VB01,0,0,0
275,1348,HOA10VB01,56,80,136
276,1327,DKA05VB01,8,0,8
277,0,CKN04VB01,0,0,0
278,0,HOA11VB01,0,0,0
279,1457,PYA06VB01,24,25,49
280,1236,CMA05VB01,6,22,28
281,1241,CMA10VB01,0,32,32
282,0,MAA05VB01,0,0,0
283,1383,LPB05VB01,0,58,58
284,1324,CUN06VB01,0,1,1
285,1340,HCA01VB01,1,0,1
286,0,PAN07VB01,0,0,0
287,1396,MCA08VB01,4,0,4
288,1434,NIA01VB01,0,4,4
289,3121,SGA02VB01,1,0,1
290,3122,SGA03VB01,83,10,93
291,1409,MHA02VB01,7,7,14
292,1299,CRA01VB01,16,0,16
293,1436,NIA04VB01,2,0,2
294,1376,LPA07VB01,5,0,5
295,1446,PAS04VB01,2,0,2
296,3128,SGA09VB01,1,8,9
297,1337,FAA07VB01,12,1,13
298,1341,HCA02VB01,4,0,4
299,1322,CUN03VB01,1,0,1
300,0,NIU01VB01,0,0,0
301,1224,CEA06VB01,25,54,79
302,0,NIC09VB01,0,0,0
303,1333,FAA02VB01,20,0,20
304,1221,CEA01VB01,3,0,3
305,1259,CMC06VB01,6,48,54
306,0,FAA05VB01,0,0,0
307,1273,CMD05VB01,47,0,47
308,1275,CMD07VB01,78,16,94
309,1211,WPA05VB01,2,0,2
310,0,SKP04VB01,0,0,0
311,0,CME02VB01,0,0,0
312,1452,PYA01VB01,74,0,74
313,0,PYB04VB01,0,0,0
314,1425,MRM05VB01,29,9,38
315,1345,HOA07VB01,2,0,2
316,1237,CMA06VB01,19,18,37
317,0,TEA09VB01,0,0,0
318,0,DKA01VB01,0,0,0
319,0,CMC07VB01,0,0,0
320,0,MLA10VB01,0,0,0
321,1200,TNG01VB01,11,4,15
322,1258,CMC05VB01,27,9,36
323,1243,CMB02VB01,4,2,6
324,1199,TEA01VB01,6,3,9
325,1415,MHA09VB01,15,3,18
326,1311,CRB05VB01,2,0,2
327,1308,CRB01VB01,3,0,3
328,1195,SKP08VB01,19,0,19
329,0,CSA07VB01,0,0,0
330,0,NIU05VB01,0,0,0
331,1209,WPA03VB01,4,0,4
332,1414,MHA08VB01,4,4,8
333,0,TNG03VB01,0,0,0
334,1208,WPA02VB01,1,0,1
335,0,LNC07VB01,0,0,0
336,1364,LNB05VB01,2,0,2
337,1312,CRB07VB01,9,0,9
338,1194,SKP07VB01,24,22,46
339,0,CSA02VB01,0,0,0
340,1366,LNB08VB01,5,1,6
341,1422,MRM02VB01,32,59,91
342,0,NIC01VB01,0,0,0
343,1304,CRA08VB01,3,0,3
344,1230,CKN01VB01,8,1,9
345,1313,CRB08VB01,10,0,10
346,0,MFU01VB01,0,0,0
347,1328,DKA06VB01,40,41,81
348,0,LPA05VB01,0,0,0
349,1310,CRB04VB01,5,0,5
350,1239,CMA08VB01,10,21,31
351,0,FAA10VB01,0,0,0
352,0,LNB07VB01,0,0,0
353,1385,LPB07VB01,33,4,37
354,1286,CMF05VB01,8,20,28
355,1204,TNG08VB01,14,7,21
356,1197,SKP10VB01,0,3,3
357,0,TEA06VB01,0,0,0
358,1343,HCA04VB01,34,0,34
359,0,MMU01VB01,0,0,0
360,0,MAA01VB01,0,0,0
361,0,NIC04VB01,0,0,0
362,1248,CMB07VB01,14,5,19
363,1291,CMU05VB01,24,29,53
364,1202,TNG05VB01,10,1,11
365,1378,LPA09VB01,0,11,11
366,1314,CRB09VB01,2,0,2
367,0,CHM04VB01,0,0,0
368,1320,CUN01VB01,0,0,0
369,1362,LNB02VB01,1,0,1
370,0,LNC08VB01,0,0,0
371,1219,CDO03VB01,4,0,4
372,0,DKA03VB01,0,0,0
373,1382,LPB04VB01,13,0,13
374,1370,LNC03VB01,0,20,20
375,1225,CEA07VB01,3,0,3
376,0,LNC09VB01,0,0,0
377,1218,CDO02VB01,11,0,11
378,0,PAS03VB01,0,0,0
379,1421,MRM01VB01,12,16,28
380,0,NIA07VB01,0,0,0
381,0,NIA05VB01,0,0,0
382,1222,CEA02VB01,6,2,8
383,1318,CSA06VB01,0,4,4
384,1330,DKA10VB01,15,0,15
385,0,CUN09VB01,0,0,0
386,1278,CMD10VB01,14,10,24
387,0,CSA10VB01,0,0,0
388,0,PAU04VB01,0,0,0
389,1441,PAN03VB01,27,0,27
